VVVVVVVVVVVVVVV
VVVVVVVVVVVVVVV
VVVVVVVVVVVVVVV
VVVVVVVVVVVVVVV
VVVVVVVVVVVVVVV
VVVVVVVVVVVVVVV
VVVVVVVVVVVVVVV
VVVVVVVVVVVVVVV
VVVVVVVVVVVVVVV
VVVVVVVVVVVVVVV
VVVVVVVVVVVVVVV
VVVVCPDBGPPPPPP
ZVVVCHVVVVVVVHV
PPPPPPVVVVVVVHV
MMMMMMMMMMMMMMM
