VVVVCVVVVVVVVCHV
VVVVCVVVVVVVVCHV
VSVVCVVVSVVVVCHV
VQVVCVVVQVVVVCHV
DBGPCPPDBGPPPCHV
VVCVCVVVVVHCVCHV
PVCVCVVVVVHCVCHV
VVCPPPPPPPPCVCHV
VVCHVCVVSVVCPCHV
GPPPVCVVQVVCHCHV
VVVVVCPDBGPPPPPP
ZVVVRCHVVVVVVVHV
PPPPPPPVVVVVVVHV
MMMMMMMMMMMMMMMM