VVVVCVVVVVVVVCHV
VVVVCVVVVVVVVCHV
VVVVCVVVVVVVVCHV
VVVVCVVVVVVVVCHV
VVVVCVVVVVVVVCHV
VVVVCVVVVVVVVCHV
DBGPCPPDVGPPPCHV
VVCVCVVVVVHCVCHV
PVCVCVVVVVHCVCHV
VVCPPPPPPPPCVCHV
VVCHVCVVVVVCPCHV
GPPPVCVVVVVCHCHV
VVVVVCPDBGPPPPPP
ZVVVVCHVVVVVVVHV
PPPPPPPVVVVVVVHV
MMMMMMMMMMMMMMMM