VVVVCVVVVVVVVCHV
VVVVCVVVVVVVVCHV
VQVVCVVVQVVVVCHV
VQVVCVVVQVVVVCHV
DQGPCPPDQGPPPCHV
VVCVCVVVVVHCVCHV
PVCVCVVVVVHCVCHV
VVCPPPPPPPPCVCHV
VVCHVCVVQVVCPCHV
GPPPVCVVQVVCHCHV
VVVVVCPDQGPPPPPP
ZVVVRCHVVVVVVVHV
PPPPPPPVVVVVVVHV
MMMMMMMMMMMMMMMM